32 32 210 14
1 5 5 1 3 6 2 2 6 5 5 3 6 5 6 2 5 5 6 5 6 6 3 5 1 6 6 3 1 5 2 3 6 3 3 5 3 5 2 2 6 5 3 3 1 3 3 3 6 2 3 3 3 6 6 2 5 2 3 3 3 5 5 2 6 3 1 1 6 3 6 6 6 1 1 6 6 6 3 5 3 1 3 1 6 6 58 62 66 62 66 62 66 62 66 62 66 62 66 62 66 62 66 62 66 62 66 62 66 62 66 62 66 62 66 62 66 62 66 62 66 62 66 62 66 66 62 66 62 66 62 66 62 66 62 66 62 66 62 66 62 66 62 66 62 66 62 66 62 66 62 66 62 66 62 66 62 66 62 66 62 66 62 66 62 66 62 66 62 66 62 66 62 66 62 66 62 66 62 66 62 66 62 66 62 66 62 66 62 66 62 66 62 66 62 66 62 66 62 66 74 3 3 3 3 3 3 3 3 3 
3 3 5 3 3 30 35 38 42 30 35 38 42 3 3 3 3 3 3 3 30 35 38 42 30 35 38 42 30 35 38 42 30 35 38 42 3 6 6 2 6 3 6 5 3 3 3 6 3 3 6 3 2 3 3 6 3 2 2 2 2 2 3 5 3 3 1 2 6 6 5 3 3 3 5 3 3 5 3 30 35 38 42 3 1 6 59 63 67 63 67 63 67 63 67 63 67 63 67 63 67 63 67 63 67 63 67 63 67 63 67 63 67 63 67 63 67 63 67 63 67 63 67 63 67 67 63 67 63 67 63 67 63 67 63 67 63 67 63 67 63 67 63 67 63 67 63 67 63 67 63 67 63 67 63 67 63 67 63 67 63 67 63 67 72 69 72 69 72 69 72 69 72 69 72 69 72 69 72 69 72 69 72 69 72 69 72 69 72 69 72 69 72 69 72 69 72 69 72 69 72 76 3 3 3 3 3 3 3 3 
3 5 3 3 26 31 36 39 43 31 36 39 45 3 3 3 3 3 3 26 31 36 39 43 31 36 39 43 31 36 39 43 31 36 39 45 3 3 3 3 3 3 3 1 3 3 3 2 6 3 6 3 3 3 5 5 3 3 3 2 2 3 3 3 3 3 3 3 1 6 3 3 3 3 3 3 3 3 26 31 36 39 45 3 5 29 60 64 60 64 60 64 60 64 60 64 60 64 60 64 60 64 60 64 60 64 60 64 60 64 60 64 60 64 60 64 60 64 60 64 60 64 60 64 60 64 60 64 60 64 60 64 60 64 60 64 60 64 60 64 60 64 60 64 60 64 60 64 60 64 60 64 60 64 60 64 60 64 64 64 60 64 60 64 70 62 66 66 62 66 62 66 62 66 62 66 62 66 62 66 62 66 62 66 62 66 62 66 62 66 62 66 62 66 62 66 62 66 62 66 62 75 77 79 89 99 110 113 113 113 
3 2 3 3 27 44 37 40 27 44 37 40 3 3 3 3 3 3 3 27 44 37 40 27 44 37 40 27 44 37 40 27 44 37 40 3 3 3 3 3 3 3 3 3 3 3 3 3 3 3 3 5 3 3 3 3 3 3 3 3 3 3 3 3 3 3 3 3 1 3 3 3 3 3 3 3 3 3 27 44 37 40 3 3 3 3 61 65 61 65 61 65 61 65 61 65 61 65 61 65 61 65 61 65 61 65 61 65 61 65 61 65 61 65 61 65 61 65 60 64 60 64 60 64 60 64 60 64 60 64 61 65 61 65 61 65 61 65 61 65 60 64 60 64 60 64 60 64 60 64 60 64 60 64 60 64 60 64 61 65 61 65 60 64 71 63 67 67 63 67 63 67 63 67 63 67 63 67 63 67 63 67 63 67 63 67 63 67 63 67 63 67 63 67 63 67 63 67 63 67 63 63 78 80 90 100 109 114 114 114 
3 3 9 16 16 16 16 33 9 16 16 33 9 16 16 16 16 16 16 16 16 16 16 33 9 16 16 16 16 16 16 16 16 16 16 33 9 16 16 16 16 16 16 16 16 16 16 33 3 6 6 3 3 3 3 3 9 16 16 16 16 16 16 16 16 33 3 3 3 3 3 3 3 3 9 16 9 16 16 16 16 16 16 16 16 33 11 18 11 18 11 18 11 18 11 18 11 18 11 18 11 18 11 18 11 18 11 18 11 18 11 18 11 18 11 18 11 18 60 64 60 64 60 64 60 64 60 64 60 64 11 18 11 18 11 18 11 18 11 18 60 64 60 64 60 64 60 64 60 64 60 64 60 64 60 64 60 64 11 18 11 18 60 64 60 64 60 64 60 64 60 64 60 64 60 64 60 64 60 64 60 64 60 64 60 64 60 64 60 64 60 64 60 64 60 64 60 64 60 64 60 64 60 81 91 100 109 112 112 112 
3 3 10 17 23 25 23 34 10 17 23 34 10 17 17 17 23 17 23 25 23 25 23 34 10 17 23 17 23 25 17 23 25 23 23 34 10 17 23 17 23 25 17 23 25 23 23 34 3 2 1 3 3 3 3 3 10 17 23 17 23 25 17 23 25 34 3 3 3 3 3 3 3 3 10 17 10 17 23 17 23 25 17 23 25 34 14 19 14 19 14 19 14 19 14 19 14 19 14 19 14 19 14 19 14 19 14 19 14 19 14 19 14 19 14 19 14 19 61 65 61 65 61 65 61 65 61 65 61 65 14 19 14 19 14 19 14 19 14 19 60 64 61 65 61 65 60 64 60 64 60 64 60 64 60 64 61 65 14 19 14 19 60 64 61 65 61 65 60 64 60 64 60 64 60 64 60 64 60 64 60 64 60 64 60 64 60 64 60 64 61 65 61 65 61 65 61 65 60 64 60 64 60 82 92 101 109 112 112 112 
3 3 11 18 11 18 11 18 11 18 11 18 11 18 11 18 11 18 11 18 11 18 11 18 11 18 11 18 11 18 11 18 11 18 11 18 11 18 11 18 11 18 11 18 11 18 11 18 3 3 3 3 3 3 3 3 11 18 11 18 11 18 11 18 11 18 3 3 3 3 3 3 3 3 11 18 11 18 11 18 11 18 11 18 11 18 11 18 11 18 13 20 13 20 13 20 13 20 13 20 13 20 13 20 13 20 13 20 13 20 13 20 13 20 13 20 11 18 11 18 11 18 11 18 11 18 11 18 11 18 11 18 13 20 13 20 13 20 13 20 60 64 11 18 11 18 60 64 60 64 60 64 60 64 60 64 11 18 11 18 13 20 60 64 11 18 11 18 60 64 60 64 60 64 60 64 60 64 60 64 60 64 60 64 60 64 60 64 60 64 11 18 11 18 11 18 11 18 60 64 60 64 60 83 93 102 109 112 112 112 
3 3 14 19 14 19 14 19 14 19 14 19 14 19 14 19 14 19 14 19 14 19 14 19 14 19 14 19 14 19 14 19 14 19 14 19 14 19 14 19 14 19 14 19 14 19 14 19 3 3 3 3 3 3 3 3 14 19 14 19 14 19 14 19 14 19 3 3 3 3 3 3 3 3 14 19 14 19 14 19 14 19 14 19 14 19 14 19 14 19 14 19 14 19 14 19 14 19 14 19 14 19 14 19 14 19 14 19 14 19 14 19 14 19 14 19 14 19 14 19 14 19 14 19 14 19 14 19 14 19 14 19 14 19 14 19 14 19 14 19 61 65 14 19 14 19 60 64 61 65 61 65 60 64 60 64 14 19 14 19 14 19 60 64 14 19 14 19 61 65 61 65 61 65 61 65 60 64 60 64 60 64 60 64 60 64 61 65 61 65 14 19 14 19 14 19 14 19 61 65 60 64 60 84 94 103 109 112 112 112 
4 4 13 20 13 20 13 20 13 20 11 18 11 18 11 18 13 20 13 20 13 20 13 20 13 20 11 18 11 18 13 20 13 20 13 20 13 20 13 20 13 20 13 20 13 20 13 20 4 4 4 4 4 4 4 4 13 20 13 20 13 20 13 20 13 20 4 4 4 4 4 4 4 4 13 20 13 20 13 20 13 20 13 20 13 20 13 20 13 20 13 20 13 20 13 20 13 20 13 20 11 18 11 18 11 18 11 18 11 18 11 18 11 18 13 20 13 20 13 20 13 20 13 20 13 20 13 20 13 20 13 20 13 20 13 20 13 20 11 18 11 18 11 18 13 20 60 64 11 18 11 18 60 64 60 64 13 20 13 20 13 20 60 64 13 20 11 18 11 18 11 18 11 18 11 18 60 64 60 64 60 64 60 64 60 64 11 18 11 18 13 20 13 20 13 20 13 20 11 18 60 64 60 85 95 104 108 115 115 115 
4 4 14 21 14 21 14 21 14 21 14 19 14 19 14 19 14 21 14 21 14 21 14 21 14 21 14 19 14 19 14 21 14 21 14 21 14 21 14 21 11 18 11 18 11 18 14 21 4 4 4 4 4 4 4 4 14 21 14 21 14 21 14 21 14 21 4 4 4 4 4 4 4 4 14 21 14 21 14 21 14 21 14 21 14 21 14 21 14 21 14 21 14 21 11 18 11 18 14 21 14 19 14 19 14 19 14 19 14 19 14 19 14 19 14 21 14 19 14 19 14 19 14 19 14 19 14 19 14 19 14 19 14 21 11 18 14 21 14 19 14 19 14 19 14 19 60 64 14 19 14 19 61 65 61 65 14 19 14 19 11 18 60 64 14 19 14 19 14 19 14 19 14 19 14 19 60 64 60 64 61 65 61 65 60 64 14 19 14 19 14 21 11 18 11 18 11 18 14 19 61 65 60 86 96 105 109 112 112 112 
4 7 13 20 13 20 13 20 13 20 13 20 13 20 13 20 11 18 13 20 13 20 11 18 13 20 13 20 13 20 13 20 13 20 13 20 13 20 13 20 50 51 50 51 50 51 13 20 54 4 4 4 4 4 4 7 13 20 13 20 13 20 13 20 13 20 54 4 4 4 4 4 4 7 13 20 13 20 13 20 13 20 13 20 13 20 13 20 13 20 13 20 13 20 50 51 50 51 13 20 13 20 13 20 13 20 13 20 13 20 13 20 13 20 13 20 13 20 13 20 13 20 11 18 11 18 13 20 11 18 11 18 13 20 50 51 13 20 13 20 13 20 13 20 13 20 60 64 13 20 11 18 11 18 11 18 13 20 13 20 50 51 60 64 13 20 13 20 13 20 13 20 13 20 13 20 60 64 60 64 11 18 11 18 60 64 13 20 13 20 13 20 50 51 50 51 50 51 13 20 11 18 60 87 97 106 109 112 112 112 
4 8 15 22 15 22 15 22 15 41 14 21 14 21 14 21 14 21 14 21 14 21 14 21 49 68 14 21 14 21 49 22 15 22 15 68 14 21 14 21 14 21 14 21 14 21 49 15 48 4 4 4 4 4 4 8 22 15 22 15 22 15 15 22 22 15 48 4 4 4 4 4 4 8 15 15 22 41 14 21 14 21 14 21 14 21 14 21 14 21 14 21 14 21 14 21 14 21 49 68 14 21 14 21 14 21 14 21 14 21 14 21 14 21 14 21 14 21 14 21 14 21 14 19 14 19 14 21 14 19 14 19 14 21 14 21 14 21 14 21 14 21 14 21 14 21 60 64 14 21 14 19 14 19 14 19 14 21 14 21 14 19 60 64 14 21 14 21 14 21 14 21 14 21 14 21 61 65 60 64 14 19 14 19 60 64 14 21 14 21 14 21 14 21 14 21 14 21 14 21 14 19 61 88 98 107 109 112 112 112 
4 4 4 4 4 4 4 4 4 8 22 15 22 15 22 15 22 46 11 18 11 18 47 15 48 8 15 15 15 15 48 4 4 4 4 8 15 46 11 18 11 18 47 22 15 22 48 4 4 4 4 4 4 4 4 4 4 4 4 4 4 4 4 4 4 4 4 4 4 4 4 4 4 4 4 4 4 8 15 15 22 15 15 22 15 15 22 46 11 18 11 18 11 18 47 15 22 15 48 8 15 22 15 15 22 15 15 22 15 46 11 18 11 18 11 18 11 18 11 18 11 18 13 20 13 20 13 20 13 20 13 20 13 20 13 20 13 20 13 20 13 20 13 20 13 20 60 64 11 18 13 20 13 20 13 20 13 20 11 18 13 20 60 64 13 20 13 20 13 20 13 20 11 18 11 18 11 18 60 64 13 20 13 20 60 64 13 20 13 20 11 18 11 18 11 18 11 18 11 18 11 18 11 18 11 108 111 112 112 112 
4 4 4 4 4 4 4 4 4 4 4 4 4 4 4 4 4 8 22 22 22 22 48 4 4 4 4 4 4 4 4 4 4 4 4 4 4 8 15 22 15 22 48 4 4 4 4 4 4 4 4 4 4 4 4 4 4 4 4 4 4 4 4 4 4 4 4 4 4 4 4 4 4 4 4 4 4 4 4 4 4 4 4 4 4 4 4 8 22 15 22 15 22 15 48 4 4 4 4 4 4 4 4 4 4 4 4 4 4 8 15 68 14 19 14 19 14 19 14 19 14 19 14 19 14 19 14 19 14 19 14 19 14 21 14 21 14 21 14 21 14 21 14 21 14 19 60 64 14 19 14 19 14 19 14 19 14 19 14 19 14 19 60 64 14 19 14 21 14 21 14 21 14 19 14 19 14 19 60 64 14 21 14 21 60 64 14 21 14 21 14 19 14 19 14 19 14 19 14 19 14 19 14 19 14 109 112 112 112 112