1000 103 300 300 48 72 101

1003 100 200 200 48 48 -1
1003 101 1200 200 48 48 -1
1003 102 2000 150 48 48 -1
1004 104 64 240 1472 15 -1

2 209 1536 208 256 16 -1
2 211 2112 208 256 16 -1

1005 222 500 148 48 48 -1